6 6 6 6 6 6 6 6 6 6 6 6 6 6 6 6 6 6 6 6 6 6 6 6 6 6 6 6 6 6 6 6 6 6 6 6 6 6 6 6 6 6 6 6 6 6 6 6 6 6 6 6 6 6 6 6 6 6 6 6 6 6 6 6 6 6 6 6 6 6 6 6 6 6 6 6 6 6 6 6 6 6 6 6 6 6 6 6 6 6 6 6 6 6 6 6 6 6 6 6
6 6 6 6 6 6 6 6 6 6 6 6 6 6 6 6 6 6 6 6 6 6 6 6 6 6 6 6 6 6 6 6 6 6 6 6 6 6 6 6 6 6 6 6 6 6 6 6 6 6 6 6 6 6 6 6 6 6 6 6 6 6 6 6 6 6 6 6 6 6 6 6 6 6 6 6 6 6 6 6 6 6 6 6 6 6 6 6 6 6 6 6 6 6 6 6 6 6 6 6
6 6 6 6 6 6 6 6 6 6 6 6 6 6 6 6 6 6 6 6 6 6 6 6 6 6 6 6 6 6 6 6 6 6 6 6 6 6 6 6 6 6 6 6 6 6 6 6 6 6 6 6 6 6 6 6 6 6 6 6 6 6 6 6 6 6 6 6 6 6 6 6 6 6 6 6 6 6 6 6 6 6 6 6 6 6 6 6 6 6 6 6 6 6 6 6 6 6 6 6
6 6 6 2 2 0 2 2 0 2 0 0 0 2 0 2 2 0 1 1 1 1 0 8 8 0 8 8 8 0 2 1 1 1 1 1 1 1 3 4 8 0 8 8 8 8 0 8 0 8 4 3 3 3 3 4 8 8 1 1 1 1 0 8 8 0 8 0 8 0 8 8 8 0 8 0 1 1 1 1 0 1 1 0 8 8 8 0 8 4 4 3 3 4 1 1 1 1 1 1
6 6 6 2 0 8 0 8 8 0 1 0 0 8 8 8 8 8 1 1 1 8 0 8 8 0 8 0 2 0 8 1 1 1 1 1 1 3 4 8 8 8 0 8 0 8 0 8 0 8 4 3 3 3 3 4 8 8 1 1 1 1 8 8 0 8 0 8 0 8 8 8 0 8 0 0 1 1 1 1 0 1 1 0 8 8 8 0 0 4 4 3 3 4 4 1 1 1 1 1
6 6 6 0 8 8 8 0 8 0 8 8 0 0 0 8 0 8 1 1 8 0 0 0 0 1 1 1 1 1 1 1 1 1 1 1 3 3 4 8 8 0 8 0 8 0 8 0 8 8 8 4 4 4 4 0 8 8 1 1 1 1 8 8 0 0 8 0 8 0 8 8 8 0 8 0 1 1 1 1 8 8 8 0 8 8 0 8 8 8 4 4 4 4 4 1 1 1 1 1
6 6 6 0 0 8 8 8 8 0 8 0 8 8 0 8 0 8 8 8 8 8 0 8 0 0 1 1 1 1 1 1 1 1 1 3 3 4 4 
6 6 6 2 0 8 0 8 8 8 8 0 8 0 8 8 8 8 8 0 0 8 0 0 8 0 0 1 1 1 1 1 1 1 1 3 4 4
6 6 6 0 1 8 0 8 8 0 8 8 0 8 8 8 8 0 8 0 8 8 8 0 8 0 8 0 1 1 1 1 1 1 1 3 4
6 6 6 8 8 0 8 0 8 8 0 0 0 8 0 8 0 8 8 0 8 0 0 0 0 8 0 8 0 8 0 8 0 0 3 4 4
6 6 6 8 0 8 8 8 0 8 0 8 0 8 8 0 8 8 1 1 8 0 0 0 8 0 8 0 8 0 8 8 0 8 3 4 
6 6 6 0 8 8 8 8 8 0 8 8 0 8 0 8 8 0 1 1 1 0 0 0 8 0 8 8 0 0 0 0 1 1 3 4
6 6 6 8 0 0 0 0 8 0 8 8 8 0 8 0 0 8 1 1 1 8 8 0 8 0 0 8 0 0 8 1 1 1 3 4 4
6 6 6 0 8 0 8 0 0 0 8 0 8 0 8 0 8 0 1 1 1 0 8 0 8 0 8 8 0 8 0 1 1 1 3 4 3 
6 6 6 8 0 8 8 7 7 7 7 0 8 0 8 8 0 8 1 1 1 5 5 5 5 5 5 5 5 0 0 1 1 1 1 1 1  
6 6 6 8 8 8 0 7 7 7 7 0 8 8 8 0 8 8 1 1 1 5 8 8 8 8 8 8 5 0 8 1 1 1 1 1 3 4 
6 6 6 0 0 8 8 7 7 7 7 8 8 0 8 0 8 8 1 1 1 5 8 8 8 8 8 8 8 8 0 8 1 1 1 1 3 4 
6 6 6 8 8 8 0 7 7 7 7 0 8 8 8 0 8 0 1 1 1 5 8 8 8 8 8 8 8 0 0 8 0 1 1 1 3 4
6 6 6 0 8 0 8 7 7 7 7 7 7 7 7 7 7 7 1 1 1 5 8 8 8 8 8 8 5 8 8 0 8 1 1 1 3 4
6 6 6 0 8 8 8 7 7 7 7 7 7 7 7 7 7 7 1 1 1 5 5 5 5 5 5 5 5 8 0 8 8 8 1 1 3 4
6 6 6 8 0 8 8 7 7 7 7 7 7 7 7 7 7 7 1 1 1 4 4 4 4 4 4 4 4 4 8 0 8 8 8 3 3 4 
6 6 6 8 8 0 8 7 7 7 7 7 7 7 7 7 7 7 1 1 1 3 3 4 8 8 0 8 0 8 8 0 8 8 0 8 4 4
6 6 6 1 1 1 8 8 0 8 0 8 8 8 7 7 7 7 1 1 1 3 3 4 8 0 8 0 8 
6 6 6 1 1 1 1 8 0 8 0 0 0 0 7 7 7 7 1 1 1 1 3 3 4
6 6 6 1 1 1 1 8 8 8 0 8 0 8 7 7 7 7 1 1 1 1 3 3 4 4
6 6 6 1 1 1 8 0 8 8 8 0 8 0 7 7 7 7 1 1 1 1 1 3 3 3 4
6 6 6 1 1 1 1 8 8 0 8 8 8 0 7 7 7 7 7 7 7 7 7 7 7 7 7 7 7 7 7 
6 6 6 1 1 1 8 8 8 0 8 0 8 0 7 7 7 7 7 7 7 7 7 7 7 7 7 7 7 7 7 
6 6 6 1 1 1 0 8 8 8 0 8 8 8 7 7 7 7 7 7 7 7 7 7 7 7 7 7 7 7 7
6 6 6 1 1 1 1 1 0 8 0 8 0 8 7 7 7 7 7 7 7 7 7 7 7 7 7 7 7 7 7
6 6 6 1 1 1 1 1 1 1 1 1 8 0 4 3 4 4 4 4 3 4 8 8 0 8 0 7 7 7 7 
6 6 6 1 1 1 1 1 1 1 1 1 1 1 1 1 1 1 1 1 1 1 1 1 1 3 3 7 7 7 7
6 6 6 1 1 1 1 1 1 1 1 1 1 1 1 1 1 1 1 1 1 1 1 1 1 1 3 7 7 7 7 
6 6 6 1 1 1 1 1 1 1 1 1 1 1 1 1 1 1 1 1 1 1 1 1 1 1 3 7 7 7 7 
6 6 6 1 1 1 1 1 1 1 1 1 1 1 1 1 1 1 1 1 1 1 1 1 1 1 3 7 7 7 7 
6 6 6 1 1 1 1 1 1 1 1 1 1 1 1 1 1 1 1 1 1 1 1 1 1 3 3 7 7 7 7 
6 6 6 1 1 1 1 1 1 1 1 1 1 1 1 1 1 1 1 1 1 1 1 1
6 6 6 1 1 1 1 1 1 1 1 1 1 1 1 1 1 1 1 1 1 1
6 6 6 1 1 1 1 1 1 1 1 1 8 8 1 1 1 1 1 1 
6 6 6 1 1 1 1 1 1 1 1 1 8 8 1 1 1 1 1 1 
6 6 6 1 1 1 1 1 1 1 1 1 8 8 1 1 1 1 1 1
6 6 6 1 1 1 1 1 1 1 1 1 8 8 1 1 1 1 1 1
6 6 6 1 1 8 8 8 8 8 8 8 8 8 1 1 1 1 1 1
6 6 6 1 1 8 8 8 8 8 8 8 8 8 1 1 1 1 1 1
6 6 6 1 1 8 8 1 1 1 1 1 1 1 1 1 1 1 1
6 6 6 1 1 8 8 1 1 1 1 1 1 1 1 1 1 1
6 6 6 1 1 8 8 1 1 1 1 1 1 1 1 1 1 1
6 6 6 1 1 8 8 1 1 1 1 1 1 1 1 1 1
6 6 6 1 1 8 8 1 1 1 1 1 1 1 1 1 1
6 6 6 1 1 8 8 1 1 1 1 1 1 1 1 1
6 6 6 1 0 8 8 0 1 1 1 1 1 1 1 1 
6 6 6 1 8 0 0 0 0 0 1 1 1 1 1 1 
6 6 6 1 0 0 0 0 0 8 0 1 1 1 1 1 
6 6 6 8 8 0 8 0 8 8 0 8 0 8 1 1 4 4 4 
6 6 6 8 0 8 8 0 8 0 8 8 0 8 1 1 3 4 4 4
6 6 6 8 8 0 8 0 8 0 8 8 0 0 1 1 1 3 4 4 4 4
6 6 6 8 0 8 8 8 0 8 0 8 0 8 1 1 1 1 3 3 3 4
6 6 6 8 0 8 0 8 8 8 0 8 0 8 0 8 1 1 1 1 3 4
6 6 6 0 8 0 8 8 8 0 8 0 8 0 8 0 1 1 1 1 3 4
6 6 6 8 8 8 0 8 0 8 8 0 0 5 5 5 5 5 1 1 3 4
6 6 6 8 0 0 0 8 0 8 8 0 8 5 8 8 8 5 1 1 3 4
6 6 6 0 8 8 8 0 8 0 8 8 0 8 8 8 8 5 1 1 3 4
6 6 6 8 8 0 8 0 8 8 0 8 0 5 8 8 8 5 1 1 3 4
6 6 6 0 8 8 0 8 8 8 0 8 0 5 5 5 5 5 1 1 3 4
6 6 6 5 5 5 5 5 8 0 8 0 8 0 8 8 8 8 1 1 3 3 4
6 6 6 5 8 8 8 8 0 8 0 8 0 8 8 8 8 0 7 7 7 7 7 7 7 
6 6 6 5 8 8 8 8 0 8 8 8 8 0 8 0 8 0 7 7 7 7 7 7 7
6 6 6 5 8 8 8 8 0 8 8 8 0 8 8 0 8 0 1 1 3 3 4 7 7
6 6 6 5 5 5 5 5 0 8 8 0 8 8 8 0 8 0 1 1 3 3 4 7 7
6 6 6 8 8 0 8 0 8 8 0 8 0 0 0 8 0 8 1 1 3 3 4 7 7
6 6 6 1 1 1 1 1 1 1 1 1 1 1 1 1 1 1 1 1 3 4
6 6 6 1 1 1 1 1 1 1 1 1 1 1 1 1 1 1 1 1 3 4
6 6 6 3 3 3 3 3 3 3 3 3 3 3 3 3 3 3 3 3 3 4
6 6 6 4 4 4 4 4 4 4 4 4 4 4 4 4 4 4 4 4 4 4
6 6 6
6 6 6
6 6 6
6 6 6
6 6 6 
6 6 6
6 6 6
6 6 6
6 6 6
6 6 6
6 6 6
6 6 6
6 6 6
6 6 6
6 6 6
6 6 6
6 6 6
6 6 6
6 6 6
6 6 6
6 6 6
6 6 6
6 6 6
6 6 6 
6 6 6
6 6 6